RETPRRRRRRRRRRRRRRRRRRRRRRRRRRRRRRRRRRRRRRRRRRRRRR
RRRRRRRRRRRRRRRRRRRRRRRRRRRRRRRRRRRRRRRRRRRRRRRRRR
RRRREEEEEEEEEEEEEEEERRRREERRRREEEERRRREEEEEEEERRRR
RRRREEEEEEEEEEEEEEEERRRREERRRREEEERRRREEEEEEEERRRR
RRRREEEEEEEEEEEEEEEERRRREERRRREEEERRRREEEEEEEERRRR
RRRREEEEEEEEEEEEEEEERRRREERRRREEEERRRREEEEEEEERRRR
RRRREEEEEEEEEEEEEEEERRRREERRRREEEERRRREEEEEEEERRRR
RRRREEEEEEEEEEEEEEEERRRREERRRREEEERRRREEEEEEEERRRR
RRRRRRRRRRRRRRRRRRRRRRRRRRRRRRRRRRRRRRRRRRRRRRRRRR
RRRRRRRRRRRRRRRRRRRRRRRRRRRRRRRRRRRRRRRRRRRRRRRRRR
RRRRRRRRRRRRRRRRRRRRRRRRRRRRRRRRRRRRRRRRRRRRRRRRRR
RRRRRRRRRRRRRRRRRRRRRRRRRRRRRRRRRRRRRRRRRRRRRRRRRR
RRRREEEEEEEEEEEEEEEERRRREERRRREEEERRRREEEEEEEERRRR
RRRREEEEEEEEEEEEEEEERRRREERRRREEEERRRREEEEEEEERRRR
RRRREEEEEEEEEEEEEEEERRRREERRRREEEERRRREEEEEEEERRRR
RRRREEEEEEEEEEEEEEEERRRREERRRREEEERRRREEEEEEEERRRR
RRRREEEEEEEEEEEEEEEERRRREERRRREEEERRRREEEEEEEERRRR
RRRREEEEEEEEEEEEEEEERRRREERRRREEEERRRREEEEEEEERRRR
RRRRRRRRRRRRRRRRRRRRRRRRRRRRRRRRRRRRRRRRRRRRRRRRRR
RRRRRRRRRRRRRRRRRRRRRRRRRRRRRRRRRRRRRRRRRRRRRRRRRR
RRRRRRRRRRRRRRRRRRRRRRRRRRRRRRRRRRRRRRRRRRRRRRRRRR
RRRRRRRRRRRRRRRRRRRRRRRRRRRRRRRRRRRRRRRRRRRRRRRRRR
RRRREEEEEEEEEEEEEEEERRRREERRRREEEERRRREEEEEEEERRRR
RRRREEEEEEEEEEEEEEEERRRREERRRREEEERRRREEEEEEEERRRR
RRRREEEEEEEEEEEEEEEERRRREERRRREEEERRRREEEEEEEERRRR
RRRREEEEEEEEEEEEEEEERRRREERRRREEEERRRREEEEEEEERRRR
RRRREEEEEEEEEEEEEEEERRRREERRRREEEERRRREEEEEEEERRRR
RRRREEEEEEEEEEEEEEEERRRREERRRREEEERRRREEEEEEEERRRR
RRRREEEEEEEEEEEEEEEERRRREERRRREEEERRRREEEEEEEERRRR
RRRRRRRRRRRRRRRRRRRRRRRRRRRRRRRRRRRRRRRRRRRRRRRRRR
RRRRRRRRRRRRRRRRRRRRRRRRRRRRRRRRRRRRRRRRRRRRRRRRRR
RRRRRRRRRRRRRRRRRRRRRRRRRRRRRRRRRRRRRRRRRRRRRRRRRR
RRRRRRRRRRRRRRRRRRRRRRRRRRRRRRRRRRRRRRRRRRRRRRRRRR
RRRREEEEEEEEEEEEEEEERRRREERRRREEEERRRREEEEEEEERRRR
RRRREEEEEEEEEEEEEEEERRRREERRRREEEERRRREEEEEEEERRRR
RRRREEEEEEEEEEEEEEEERRRREERRRREEEERRRREEEEEEEERRRR
RRRREEEEEEEEEEEEEEEERRRREERRRREEEERRRREEEEEEEERRRR
RRRREEEEEEEEEEEEEEEERRRREERRRREEEERRRREEEEEEEERRRR
RRRREEEEEEEEEEEEEEEERRRREERRRREEEERRRREEEEEEEERRRR
RRRREEEEEEEEEEEEEEEERRRREERRRREEEERRRREEEEEEEERRRR
RRRREEEEEEEEEEEEEEEERRRREERRRREEEERRRREEEEEEEERRRR
RRRRRRRRRRRRRRRRRRRRRRRRRRRRRRRRRRRRRRRRRRRRRRRRRR
RRRRRRRRRRRRRRRRRRRRRRRRRRRRRRRRRRRRRRRRRRRRRRRRRR
RRRREEEEEEEEEEEEEEEERRRREERRRREEEERRRREEEEEEEERRRR
RRRREEEEEEEEEEEEEEEERRRREERRRREEEERRRREEEEEEEERRRR
RRRREEEEEEEEEEEEEEEERRRREERRRREEEERRRREEEEEEEERRRR
RRRRRRRRRRRRRRRRRRRRRRRRRRRRRRRRRRRRRRRRRRRRRRRRRR
RRRRRRRRRRRRRRRRRRRRRRRRRRRRRRRRRRRRRRRRRRRRRRRRRR