__________________________________________________
_XXXXX_XX_XXXXX_XXXXXX_XXXXXXXXXXXX_XXXXXXX_XXXXX_
_XXXXX_XX_XXXXX_XXXXXX_XXXXXXXXXXXX_________XXXXX_
_XXXXX_XX_XXXXX_XXXXXX_XXXXXXXXXXXX_XXXXXXX_______
________________XXXX__________XXXXX_XXXXXXX_XXXXX_
_XXXX_XXXX_XXXX_XXXX_XXXX_XXX_XXXXX_XXXXXXX_XXXXX_
_XXXX_XXXX__XXX_XXXX_XX___XXX_______XXXXXXX_XXXXX_
_XXXX_XXXXX_XXX_XXXX_XX_XXXXXXXXXXX_XXXXXXX_XXXXX_
______________________________XXXXX_________XXXXX_
_XXXXXXXXXX_XXXXXXX_XXXXXXXXX_XXXXX_XXXXXXXXXXXXX_
_XXXXXXXXXX_XXXXXXX_XXXXXXXXX_XXXXX_XXXXXXXXXXXXX_
_XXX__________XXX________XXXX_XXXXX_______XXXX____
_XXX_XXXXX_XX_XXXX_XXXXX_XXXX_______XXXXX______XX_
_XXX_XXXXX_XX_XXXX_XXXXX______XXXXX_XXXXXXXXXXXXX_
______________XXXX_XXXXX_XXXXXXXXXX_XXXXXXXXXXXXX_
_XXX_XXXXX_XX_XXXX_XXXXX_XXXXXXXXXX_XXXXXXXXXXXXX_
_XXX_XXXXX_XX_XXXX_XXXXX_XXXXXXXXXX_XXXXXXXXXXXXX_
__________________________________________________
_XXXXXXXXXXXXXX_XXXXXXXXXXXXX_XXXXXXXXXXXXXXXXXXX_
_XXXXXXXXXXXXXX_XXXXXXXXXXXXX_XXXXXXXXXXXXXXXXXXX_
_XXXXXXXXXX_________XXXXXXXXX_XXXXXXXXXXXXXXXXXXX_
____________XXXXXXX___________XXXXXXXXXXXXXXXXXXX_
_XXXXXXXXXXXXXXXXXXXXX_XXXXXX_____________________
_XXXXXXXXXXXXXXXXXXXXX_XXXXXX_XXXXXXXXXXXXXXXXXXX_
_XXXXXXXXXXXXXXXXXXXXX_XXXXXX__________XXXXXXXXXX_
_XXXXXX____XXXXXXXXXXX_XXXXXXXXXX_XXXX_XXXXXXXXXX_
_XXXXXX_XX______XXXXXX_XXXXXXXXXX_XXXX_XXXXXXXXXX_
_XXXXXX_XX_XXXX_XXXXXX_XXXXX______XXXX____XXXXXXX_
_XXXXXX_XX_XXXX_XXXXXX_XXXXX_XXXX_XXXXXXX_XXXXXXX_
________XX_XXXX_XXXXXX_XXXXX_XXXX_XXXX____XXXXXXX_
_XXXXXXXXX______XXXXXX_______XXXX_XXXX_XXXXXXXXXX_
_XXXXXXXXXXXXXX_______XXXXXXXXXXX_XXXX_XXXXXXXXXX_
_XXXXXX_________XXXXX_XXXXXXXXX___XXXX____________
_XXXXXX_XXXXXXXXXXXXX_XXXXXXXXX_XXXXXX_XXXXXXXXXX_
__________________________________________________
_XXXXXXXXX_XXXXXXXXX_XXXXXXXXXX_XXXXXXXXXX_XXXXXX_
_XXXXXXXXX_XXXXXXXXX_XXXXXXXXXX_XXXXXXXXXX_XXXXXX_
_XXXXXXXXX_XXXXXXXXX_XXXXXXXXXX_XXXXXXXXXX_XXXXXX_
__________________________________________________
_XXXXXXXXXXXXXXXXXXXXXXXX_XXXXXXXXXXXXXXXXXXXXXXX_
_XXXXXXXXXXXXXXXXXXXXXXXX_XXXXXXXXXXXXXXXXXXXXXXX_
_XXXXXXXXXXXX_________________________XXXXXXXXXXX_
_XXXXXXXXXXXX_XXXXXXXXXXXXXXXXXXXXXXX_XXXXXXXXXXX_
_XXXXXXXXXXXX_XXXXXXXXXXXXXXXXXXXXXXX_XXXXXXXXXXX_
______________XXXXXXXXXXXXXXXXXXXXXXX_____________
_XXXXXX_XXXXXXXXXXXXXXXXXXXXXXXXXXXXXXXXXXX_XXXXX_
_XXXXXX_XXXXXXXXXXXXXXXXXXXXXXXXXXXXXXXXXXX_XXXXX_
_XXXXXX_______XXXXXXXXXXXXXXXXXXXXXXX_______XXXXX_
_XXXXXXXXXXXX_XXXXXXXXXXXXXXXXXXXXXXX_XXXXXXXXXXX_
__________________________________________________